# Gboard Dictionary version:1
bazi	八字	zh-CN
bijian	比肩	zh-CN
jiecai	劫财	zh-CN
shishen	食神	zh-CN
shangguan	伤官	zh-CN
zhengcai	正财	zh-CN
piancai	偏财	zh-CN
zhengguan	正官	zh-CN
qisha	七杀	zh-CN
zhengyin	正印	zh-CN
pianyin	偏印	zh-CN
jiazi	甲子	zh-CN
yichou	乙丑	zh-CN
bingyin	丙寅	zh-CN
dingmao	丁卯	zh-CN
wuchen	戊辰	zh-CN
jisi	己巳	zh-CN
gengwu	庚午	zh-CN
xinwei	辛未	zh-CN
renshen	壬申	zh-CN
guiyou	癸酉	zh-CN
jiaquxu	甲戌	zh-CN
yihai	乙亥	zh-CN
bingzi	丙子	zh-CN
dingchou	丁丑	zh-CN
wuyin	戊寅	zh-CN
jimao	己卯	zh-CN
gengchen	庚辰	zh-CN
xinsi	辛巳	zh-CN
renwu	壬午	zh-CN
guiwei	癸未	zh-CN
jiashen	甲申	zh-CN
yiyou	乙酉	zh-CN
bingquxu	丙戌	zh-CN
dinghai	丁亥	zh-CN
wuzi	戊子	zh-CN
jichou	己丑	zh-CN
gengyin	庚寅	zh-CN
xinmao	辛卯	zh-CN
renchen	壬辰	zh-CN
guisi	癸巳	zh-CN
jiawu	甲午	zh-CN
yiwei	乙未	zh-CN
bingshen	丙申	zh-CN
dingyou	丁酉	zh-CN
wuquxu	戊戌	zh-CN
jihai	己亥	zh-CN
gengzi	庚子	zh-CN
xinchou	辛丑	zh-CN
renyin	壬寅	zh-CN
guimao	癸卯	zh-CN
jiachen	甲辰	zh-CN
yisi	乙巳	zh-CN
bingwu	丙午	zh-CN
dingwei	丁未	zh-CN
wushen	戊申	zh-CN
jiyou	己酉	zh-CN
gengquxu	庚戌	zh-CN
xinhai	辛亥	zh-CN
renzi	壬子	zh-CN
guichou	癸丑	zh-CN
jiayin	甲寅	zh-CN
yimao	乙卯	zh-CN
bingchen	丙辰	zh-CN
dingsi	丁巳	zh-CN
wuwu	戊午	zh-CN
jiwei	己未	zh-CN
gengshen	庚申	zh-CN
xinyou	辛酉	zh-CN
renquxu	壬戌	zh-CN
guihai	癸亥	zh-CN
jiamu	甲木	zh-CN
yimu	乙木	zh-CN
binghuo	丙火	zh-CN
dinghuo	丁火	zh-CN
wutu	戊土	zh-CN
jitu	己土	zh-CN
gengjin	庚金	zh-CN
xinjin	辛金	zh-CN
renshui	壬水	zh-CN
guishui	癸水	zh-CN
zishui	子水	zh-CN
choutu	丑土	zh-CN
yinmu	寅木	zh-CN
maomu	卯木	zh-CN
chentu	辰土	zh-CN
sihuo	巳火	zh-CN
wuhuo	午火	zh-CN
weitu	未土	zh-CN
shenjin	申金	zh-CN
youjin	酉金	zh-CN
quxutu	戌土	zh-CN
haishui	亥水	zh-CN
jiajige	甲己合	zh-CN
yigengge	乙庚合	zh-CN
bingxinge	丙辛合	zh-CN
dingrenge	丁壬合	zh-CN
wuguige	戊癸合	zh-CN
zichouge	子丑合	zh-CN
yinhaige	寅亥合	zh-CN
maoquxuge	卯戌合	zh-CN
chenyouge	辰酉合	zh-CN
sishenge	巳申合	zh-CN
wuweige	午未合	zh-CN
ziwuchong	子午冲	zh-CN
chouweichong	丑未冲	zh-CN
yinshenchong	寅申冲	zh-CN
maoyouchong	卯酉冲	zh-CN
chenquxuchong	辰戌冲	zh-CN
sihaichong	巳亥冲	zh-CN
haizhongjin	海中金	zh-CN
luzhonghuo	炉中火	zh-CN
dalinmu	大林木	zh-CN
lupangtu	路旁土	zh-CN
jianfengjin	剑锋金	zh-CN
shantouhuo	山头火	zh-CN
jianxiashui	涧下水	zh-CN
chengtoutu	城头土	zh-CN
bailajin	白腊金	zh-CN
yangliumu	杨柳木	zh-CN
quanzhongshui	泉中水	zh-CN
wushangtu	屋上土	zh-CN
pilihuo	霹雳火	zh-CN
songbaimu	松柏木	zh-CN
changliushui	长流水	zh-CN
shazhongjin	砂中金	zh-CN
shanxiahuo	山下火	zh-CN
pingdimu	平地木	zh-CN
bishangtu	壁上土	zh-CN
jinbojin	金箔金	zh-CN
fudenghuo	覆灯火	zh-CN
tianheshui	天河水	zh-CN
dayitu	大驿土	zh-CN
chaichuanjin	钗钏金	zh-CN
sangtuomu	桑拓木	zh-CN
daxishui	大溪水	zh-CN
shazhongtu	沙中土	zh-CN
tianshanghuo	天上火	zh-CN
shiliumu	石榴木	zh-CN
dahaishui	大海水	zh-CN
dayun	大运	zh-CN
liunian	流年	zh-CN
qian	乾	zh-CN
kun	坤	zh-CN
kan	坎	zh-CN
li	离	zh-CN
zhen	震	zh-CN
dui	兑	zh-CN
xun	巽	zh-CN
gen	艮	zh-CN
qiangong	乾宫	zh-CN
kungong	坤宫	zh-CN
kangong	坎宫	zh-CN
ligong	离宫	zh-CN
zhengong	震宫	zh-CN
duigong	兑宫	zh-CN
xungong	巽宫	zh-CN
gengong	艮宫	zh-CN
qianweitian	乾为天	zh-CN
tianfenggou	天风姤	zh-CN
tianshandun	天山遁	zh-CN
tiandifou	天地否	zh-CN
fengdiguan	风地观	zh-CN
shandibo	山地剥	zh-CN
huodijin	火地晋	zh-CN
huotiandayou	火天大有	zh-CN
duiweize	兑为泽	zh-CN
zeshuikun	泽水困	zh-CN
zedicui	泽地萃	zh-CN
zeshanxian	泽山咸	zh-CN
shuishanjian	水山蹇	zh-CN
dishanqian	地山谦	zh-CN
leishanxiaoguo	雷山小过	zh-CN
leizeguimei	雷泽归妹	zh-CN
liweihuo	离为火	zh-CN
huoshanlü	火山旅	zh-CN
huofengding	火风鼎	zh-CN
huoshuiweiji	火水未济	zh-CN
shanshuimeng	山水蒙	zh-CN
fengshuihuan	风水涣	zh-CN
tianshuisong	天水讼	zh-CN
tianhuotongren	天火同人	zh-CN
zhenweilei	震为雷	zh-CN
leidiyu	雷地豫	zh-CN
leishuijie	雷水解	zh-CN
leifengheng	雷风恒	zh-CN
difengsheng	地风升	zh-CN
shuifengjing	水风井	zh-CN
zefengdaguo	泽风大过	zh-CN
zeleisui	泽雷随	zh-CN
xunweifeng	巽为风	zh-CN
fengtianxiaochu	风天小畜	zh-CN
fenghuojiaren	风火家人	zh-CN
fengleiyi	风雷益	zh-CN
tianleiwuwang	天雷无妄	zh-CN
huoleishike	火雷噬嗑	zh-CN
shanleiyi	山雷颐	zh-CN
shanfenggu	山风蛊	zh-CN
kanweishui	坎为水	zh-CN
shuizejie	水泽节	zh-CN
shuileitun	水雷屯	zh-CN
shuihuojiji	水火既济	zh-CN
zehuoji	泽火革	zh-CN
leihuofeng	雷火丰	zh-CN
dihuomingyi	地火明夷	zh-CN
dishuishi	地水师	zh-CN
genweishan	艮为山	zh-CN
shanhuobi	山火贲	zh-CN
shantiandachu	山天大畜	zh-CN
shanzesun	山泽损	zh-CN
huozekui	火泽睽	zh-CN
tianzelü	天泽履	zh-CN
fengzezhongfu	风泽中孚	zh-CN
fengshanjian	风山渐	zh-CN
kunweidi	坤为地	zh-CN
dileifu	地雷复	zh-CN
dizelin	地泽临	zh-CN
ditiantai	地天泰	zh-CN
leitiandazhuang	雷天大壮	zh-CN
zetianguai	泽天夬	zh-CN
shuitianxu	水天需	zh-CN
shuidibi	水地比	zh-CN
qiangua	乾卦	zh-CN
gougua	姤卦	zh-CN
dungua	遁卦	zh-CN
fougua	否卦	zh-CN
guangua	观卦	zh-CN
bogua	剥卦	zh-CN
jingua	晋卦	zh-CN
dayougua	大有卦	zh-CN
zegua	泽卦	zh-CN
kungua	困卦	zh-CN
cuigua	萃卦	zh-CN
xiangua	咸卦	zh-CN
jiangua	蹇卦	zh-CN
qiangua	谦卦	zh-CN
xiaoguogua	小过卦	zh-CN
guimeigua	归妹卦	zh-CN
ligua	离卦	zh-CN
lügua	旅卦	zh-CN
dinggua	鼎卦	zh-CN
weijigua	未济卦	zh-CN
menggua	蒙卦	zh-CN
huangua	涣卦	zh-CN
songgua	讼卦	zh-CN
tongrengua	同人卦	zh-CN
zhengua	震卦	zh-CN
yugua	豫卦	zh-CN
jiegua	解卦	zh-CN
henggua	恒卦	zh-CN
shenggua	升卦	zh-CN
jinggua	井卦	zh-CN
daguogua	大过卦	zh-CN
suigua	随卦	zh-CN
xungua	巽卦	zh-CN
xiaochugua	小畜卦	zh-CN
jiarengua	家人卦	zh-CN
yigua	益卦	zh-CN
wuwanggua	无妄卦	zh-CN
shikegua	噬嗑卦	zh-CN
yigua	颐卦	zh-CN
gugua	蛊卦	zh-CN
kangua	坎卦	zh-CN
jiegua	节卦	zh-CN
tungua	屯卦	zh-CN
jijigua	既济卦	zh-CN
jigua	革卦	zh-CN
fenggua	丰卦	zh-CN
mingyigua	明夷卦	zh-CN
shigua	师卦	zh-CN
gengua	艮卦	zh-CN
bigua	贲卦	zh-CN
dachugua	大畜卦	zh-CN
sungua	损卦	zh-CN
kuigua	睽卦	zh-CN
lügua	履卦	zh-CN
zhongfugua	中孚卦	zh-CN
jiangua	渐卦	zh-CN
kungua	坤卦	zh-CN
fugua	复卦	zh-CN
lingua	临卦	zh-CN
taigua	泰卦	zh-CN
dazhuanggua	大壮卦	zh-CN
guaigua	夬卦	zh-CN
xugua	需卦	zh-CN
bigua	比卦	zh-CN
zhonggong	中宫	zh-CN
yibai	一白	zh-CN
erhei	二黑	zh-CN
sanbi	三碧	zh-CN
silü	四绿	zh-CN
wuhuang	五黄	zh-CN
liubai	六白	zh-CN
qichi	七赤	zh-CN
babai	八白	zh-CN
jiuzi	九紫	zh-CN
fuwei	伏位	zh-CN
shengqi	生气	zh-CN
huohai	祸害	zh-CN
yannian	延年	zh-CN
jueming	绝命	zh-CN
liusha	六煞	zh-CN
wugui	五鬼	zh-CN
tianyi	天医	zh-CN
fuyinju	伏吟局	zh-CN
fanyinju	反吟局	zh-CN
wangxiang	旺相	zh-CN
xiuqiu	休囚	zh-CN
youqi	有气	zh-CN
dufa	独发	zh-CN
dujing	独静	zh-CN
huajin	化进	zh-CN
huatui	化退	zh-CN
huakong	化空	zh-CN
huajue	化绝	zh-CN
kongwang	空亡	zh-CN
fumu	父母	zh-CN
guangui	官鬼	zh-CN
qicai	妻财	zh-CN
xiongdi	兄弟	zh-CN
zisun	子孙	zh-CN
qinglong	青龙	zh-CN
zhuque	朱雀	zh-CN
gouchen	勾陈	zh-CN
tengshe	腾蛇	zh-CN
baihu	白虎	zh-CN
xuanwu	玄武	zh-CN
shiyao	世爻	zh-CN
yingyao	应爻	zh-CN
chishi	持世	zh-CN
youhungua	游魂卦	zh-CN
guihungua	归魂卦	zh-CN
liuchonggua	六冲卦	zh-CN
liugegua	六合卦	zh-CN
guashen	卦身	zh-CN
fadong	发动	zh-CN
chuyao	初爻	zh-CN
eryao	二爻	zh-CN
sanyao	三爻	zh-CN
siyao	四爻	zh-CN
wuyao	五爻	zh-CN
shangyao	上爻	zh-CN
yima	驿马	zh-CN
xiumen	休门	zh-CN
shengmen	生门	zh-CN
shangmen	伤门	zh-CN
dumen	杜门	zh-CN
jingmen	景门	zh-CN
simen	死门	zh-CN
jingmen	惊门	zh-CN
kaimen	开门	zh-CN
zhifu	值符	zh-CN
taiyin	太阴	zh-CN
liuge	六合	zh-CN
jiudi	九地	zh-CN
jiutian	九天	zh-CN
tianpeng	天蓬	zh-CN
tianren	天任	zh-CN
tianchong	天冲	zh-CN
tianfu	天辅	zh-CN
tianying	天英	zh-CN
tianrui	天芮	zh-CN
tianzhu	天柱	zh-CN
tianxin	天心	zh-CN
menpo	门迫	zh-CN
jixing	击刑	zh-CN
tianqin	天禽	zh-CN
mingtang	明堂	zh-CN
jinkui	金匮	zh-CN
siming	司命	zh-CN
tianxing	天刑	zh-CN
tianlao	天牢	zh-CN
tiande	天德	zh-CN
yuede	月德	zh-CN
tianyiguiren	天乙贵人	zh-CN
yutangguiren	玉堂贵人	zh-CN
yutang	玉堂	zh-CN
guiren	贵人	zh-CN
tiankong	天空	zh-CN
taichang	太常	zh-CN
tianhou	天后	zh-CN
yuejiang	月将	zh-CN
shenhou	神后	zh-CN
daji	大吉	zh-CN
gongcao	功曹	zh-CN
taichong	太冲	zh-CN
tiangang	天罡	zh-CN
taiyi	太乙	zh-CN
shengguang	胜光	zh-CN
xiaoji	小吉	zh-CN
chuansong	传送	zh-CN
congkui	从魁	zh-CN
hekui	河魁	zh-CN
dengming	登明	zh-CN
jinlianru	进连茹	zh-CN
tuilianru	退连茹	zh-CN
jinjianchuan	进间传	zh-CN
tuijianchuan	退间传	zh-CN
qinhaike	侵害课	zh-CN
yuanshouke	元首课	zh-CN
zhongshenke	重审课	zh-CN
zhiyike	知一课	zh-CN
shehaike	涉害课	zh-CN
yaokeke	遥克课	zh-CN
maoxingke	昴星课	zh-CN
biezeke	别责课	zh-CN
bazhuanke	八专课	zh-CN
fuyinke	伏吟课	zh-CN
fanyinke	反吟课	zh-CN
sanguangke	三光课	zh-CN
sanyangke	三阳课	zh-CN
sanqike	三奇课	zh-CN
liuyike	六仪课	zh-CN
shitaike	时泰课	zh-CN
guanjueke	官爵课	zh-CN
fuguike	富贵课	zh-CN
longdeke	龙德课	zh-CN
xuangeke	轩盖课	zh-CN
zhuyinke	铸印课	zh-CN
zhuolunke	斫轮课	zh-CN
yincongke	引从课	zh-CN
hengtongke	亨通课	zh-CN
fanchangke	繁昌课	zh-CN
ronghuake	荣华课	zh-CN
deqingke	德庆课	zh-CN
gehuanke	合欢课	zh-CN
hemeike	和美课	zh-CN
zhanguanke	斩关课	zh-CN
bikouke	闭口课	zh-CN
youzike	游子课	zh-CN
sanjiaoke	三交课	zh-CN
luanshouke	乱首课	zh-CN
zhuixuke	赘婿课	zh-CN
chongpoke	冲破课	zh-CN
yin泆ke	淫泆课	zh-CN
wuyinke	芜淫课	zh-CN
guguake	孤寡课	zh-CN
dueke	度厄课	zh-CN
wulujuesike	无禄绝嗣课	zh-CN
zhunfuke	迍福课	zh-CN
xingshangke	刑伤课	zh-CN
tianfanke	天烦课	zh-CN
tianhuoke	天祸课	zh-CN
tianyuke	天狱课	zh-CN
tiankouke	天寇课	zh-CN
tianwangke	天网课	zh-CN
pohuake	魄化课	zh-CN
sanyinke	三阴课	zh-CN
longzhanke	龙战课	zh-CN
siqike	死奇课	zh-CN
zaieke	灾厄课	zh-CN
yangjiuke	殃咎课	zh-CN
jiuchouke	九丑课	zh-CN
guimuke	鬼墓课	zh-CN
lideke	励德课	zh-CN
panzhuke	盘珠课	zh-CN
quanjuke	全局课	zh-CN
yuantaike	元胎课	zh-CN
lianzhuke	连珠课	zh-CN
jianchuanke	间传课	zh-CN
liuchunke	六纯课	zh-CN
wuleike	物类课	zh-CN
shiruke	始入课	zh-CN
biyongke	比用课	zh-CN
sanchuan	三传	zh-CN
sike	四课	zh-CN
xingnian	行年	zh-CN
nianming	年命	zh-CN
jiao	角	zh-CN
kang	亢	zh-CN
shi	氏	zh-CN
fang	房	zh-CN
xin	心	zh-CN
wei	尾	zh-CN
ji	箕	zh-CN
dou	斗	zh-CN
niu	牛	zh-CN
nü	女	zh-CN
xu	虚	zh-CN
wei	危	zh-CN
shi	室	zh-CN
bi	壁	zh-CN
kui	奎	zh-CN
lou	娄	zh-CN
wei	胃	zh-CN
ang	昂	zh-CN
bi	毕	zh-CN
zi	觜	zh-CN
can	参	zh-CN
jing	井	zh-CN
gui	鬼	zh-CN
liu	柳	zh-CN
xing	星	zh-CN
zhang	张	zh-CN
yi	翼	zh-CN
zhen	轸	zh-CN
baiyangzuo	白羊座	zh-CN
jinniuzuo	金牛座	zh-CN
shuangzizuo	双子座	zh-CN
juxiezuo	巨蟹座	zh-CN
shizizuo	狮子座	zh-CN
chunüzuo	处女座	zh-CN
tianchengzuo	天秤座	zh-CN
tianxiezuo	天蝎座	zh-CN
sheshouzuo	射手座	zh-CN
mojiezuo	摩羯座	zh-CN
shuipingzuo	水瓶座	zh-CN
shuangyuzuo	双鱼座	zh-CN
muyangzuo	牡羊座	zh-CN
renmazuo	人马座	zh-CN
shefuzuo	蛇夫座	zh-CN
guan	官	zh-CN
sha	杀	zh-CN
cai	财	zh-CN
yin	印	zh-CN
bi	比	zh-CN
jie	劫	zh-CN
shi	食	zh-CN
shang	伤	zh-CN
xiaoyin	枭印	zh-CN
yangren	阳刃	zh-CN
baicai	败财	zh-CN
yinshou	印绶	zh-CN
shenwangdi	身旺地	zh-CN
shishangdi	食伤地	zh-CN
caidi	财地	zh-CN
guanshadi	官杀地	zh-CN
bijiedi	比劫地	zh-CN
shichen	时辰	zh-CN
fenjin	分金	zh-CN
beilu	背禄	zh-CN
xianglu	向禄	zh-CN
zhuma	逐马	zh-CN
xiangguan	向官	zh-CN
lincai	临财	zh-CN
panan	攀鞍	zh-CN
guluan	孤鸾	zh-CN
jiangxing	将星	zh-CN
taijiguiren	太极贵人	zh-CN
zaisha	灾煞	zh-CN
yinchayangcuo	阴差阳错	zh-CN
guoyinguiren	国印贵人	zh-CN
hongyan	红艳	zh-CN
jinyu	金舆	zh-CN
xianchi	咸池	zh-CN
taohua	桃花	zh-CN
huage	华盖	zh-CN
liue	六厄	zh-CN
disha	地煞	zh-CN
guanfu	官符	zh-CN
juanshe	卷舌	zh-CN
maier	埋儿	zh-CN
bazhuan	八专	zh-CN
jiuchou	九丑	zh-CN
feilian	飞廉	zh-CN
yuanchen	元辰	zh-CN
goujiao	勾绞	zh-CN
tiansao	天扫	zh-CN
disao	地扫	zh-CN
jielukongwang	截路空亡	zh-CN
zhaisha	宅煞	zh-CN
musha	墓煞	zh-CN
wangshen	亡神	zh-CN
jiesha	劫煞	zh-CN
tianxi	天喜	zh-CN
jinshen	金神	zh-CN
wenchang	文昌	zh-CN
yangren	羊刃	zh-CN
posui	破碎	zh-CN
tianzhong	天中	zh-CN
shiling	十灵	zh-CN
bingfu	病符	zh-CN
sifu	死符	zh-CN
liuxia	流霞	zh-CN
guchen	孤辰	zh-CN
guasu	寡宿	zh-CN
jingyue	旌钺	zh-CN
sangmen	丧门	zh-CN
diaoke	吊客	zh-CN
feiren	飞刃	zh-CN
sanqiu	三丘	zh-CN
wuxingzhengyin	五行正印	zh-CN
jinshen	进神	zh-CN
tuishen	退神	zh-CN
xuetang	学堂	zh-CN
ciguan	词馆	zh-CN
dexiu	德秀	zh-CN
tiansha	天煞	zh-CN
wumu	五墓	zh-CN
ziyi	自缢	zh-CN
sifeiri	四废日	zh-CN
yuesha	月煞	zh-CN
xiaohao	小耗	zh-CN
tunxian	吞陷	zh-CN
tianyueerde	天月二德	zh-CN
tiandege	天德合	zh-CN
yuedege	月德合	zh-CN
tianyuedege	天月德合	zh-CN
yuekong	月空	zh-CN
yinyang	阴阳	zh-CN
sanqi	三奇	zh-CN
jingde	旌德	zh-CN
sidakongwang	四大空亡	zh-CN
dahao	大耗	zh-CN
kuigang	魁罡	zh-CN
gejiao	隔角	zh-CN
shiwudabai	十恶大败	zh-CN
shifu	十富	zh-CN
chunzijue	纯字诀	zh-CN
qingzijue	清字诀	zh-CN
hezijue	和字诀	zh-CN
guizijue	贵字诀	zh-CN
zhuozijue	浊字诀	zh-CN
lanzijue	滥字诀	zh-CN
changzijue	娼字诀	zh-CN
yinzijue	淫字诀	zh-CN
zhengqiguanxing	正气官星	zh-CN
caiguanliangwang	财官两旺	zh-CN
guanxingdaige	官星带合	zh-CN
guanxingzuolu	官星坐禄	zh-CN
guanxingtaohua	官星桃花	zh-CN
yinshoutiande	印绶天德	zh-CN
riguicaiguan	日贵财官	zh-CN
dushayouzhi	独杀有制	zh-CN
yangrenyouzhi	羊刃有制	zh-CN
shangguanshengcai	伤官生财	zh-CN
guilufengcai	归禄逢财	zh-CN
shishenshengwang	食神生旺	zh-CN
shahuayinshou	杀化印绶	zh-CN
erdefushen	二德扶身	zh-CN
sanqigeju	三奇合局	zh-CN
gonglugonggui	拱禄拱贵	zh-CN
guanguifengguan	官贵逢官	zh-CN
shishenshengcai	食神生财	zh-CN
guanshahunza	官杀混杂	zh-CN
shangguantaizhong	伤官太重	zh-CN
tancaihuaiyin	贪财坏印	zh-CN
bijianzhongfan	比肩重犯	zh-CN
caiguanyujie	财官遇劫	zh-CN
caiduoshenruo	财多身弱	zh-CN
yangrenchongxing	羊刃冲刑	zh-CN
jinshendairen	金神带刃	zh-CN
wuguanjiange	无官见合	zh-CN
duoguanduoge	多官多合	zh-CN
taohuadaige	桃花带合	zh-CN
daochataohua	倒插桃花	zh-CN
shenwangwuyi	身旺无依	zh-CN
daoshizhongfan	倒食重犯	zh-CN
wuyinjiansha	无印见杀	zh-CN
bazixingchong	八字刑冲	zh-CN
shangguandaisha	伤官带杀	zh-CN
yinshouyujie	印绶遇劫	zh-CN
mingfanwusha	命犯恶煞	zh-CN
xianchiwusha	咸池恶煞	zh-CN
shazhongbengui	杀重奔贵	zh-CN
nianshangqisha	年上七杀	zh-CN
zhengguange	正官格	zh-CN
yueshangpianguange	月上偏官格	zh-CN
shishangyiweigui	时上一位贵	zh-CN
shiguige	时贵格	zh-CN
suidefusha	岁德扶杀	zh-CN
tianyuanzuosha	天元坐杀	zh-CN
shishangpiancaige	时上偏财格	zh-CN
feitianluma	飞天禄马	zh-CN
daochongluma	倒冲禄马	zh-CN
ziyaosige	子遥巳格	zh-CN
chouyaosige	丑遥巳格	zh-CN
jinglancha	井栏叉	zh-CN
gonglugongguige	拱禄拱贵格	zh-CN
renqilongbei	壬骑龙背	zh-CN
liujiaquqian	六甲趋乾	zh-CN
liurenqugen	六壬趋艮	zh-CN
xinggege	刑合格	zh-CN
geluge	合禄格	zh-CN
guiluge	归禄格	zh-CN
liuyishugui	六乙鼠贵	zh-CN
liuyinchaoyang	六阴朝阳	zh-CN
jiaqiuge	夹丘格	zh-CN
xuanwudangquan	玄武当权	zh-CN
gouchendewei	勾陈得位	zh-CN
runxiage	润下格	zh-CN
yanshangge	炎上格	zh-CN
congjige	从革格	zh-CN
jiasege	稼穑格	zh-CN
quzhige	曲直格	zh-CN
tujurunxia	土局润下	zh-CN
shangguanshengcaige	伤官生财格	zh-CN
shangguandaishage	伤官带杀格	zh-CN
fudexiuqi	福德秀气	zh-CN
qimingge	弃命格	zh-CN
qimingcongcai	弃命从财	zh-CN
qimingcongsha	弃命从杀	zh-CN
riguige	日贵格	zh-CN
kuigangge	魁罡格	zh-CN
jinshenge	金神格	zh-CN
huishahuayinju	会杀化印局	zh-CN
yinshouge	印绶格	zh-CN
shishenshengwangju	食神生旺局	zh-CN
ridege	日德格	zh-CN
caiguanshuangmei	财官双美	zh-CN
caiwangshengguange	财旺生官格	zh-CN
qinglongfuxing	青龙伏形	zh-CN
baihuchishi	白虎持势	zh-CN
siweichunquan	四位纯全	zh-CN
tianyuanyiqi	天元一气	zh-CN
tiandeyinshouju	天德印绶局	zh-CN
shayinxiangshengge	杀印相生格	zh-CN
zhuquechengfeng	朱雀乘风	zh-CN
yangjizhushe	羊击猪蛇	zh-CN
huwubensi	虎午奔巳	zh-CN
jinbaishuiqing	金白水清	zh-CN
muhuojiaohui	木火交辉	zh-CN
huojinzhuyin	火金铸印	zh-CN
shijiushayinge	食就杀印格	zh-CN
sangezhengcaiju	三合正财局	zh-CN
chongluge	冲禄格	zh-CN
luyuanhuhuan	禄元互换	zh-CN
shimuge	时墓格	zh-CN
mochiyongquan	墨池涌泉	zh-CN
guanyinge	官印格	zh-CN
caiguange	财官格	zh-CN
tianyuanzuoguan	天元坐官	zh-CN
yinren	阴刃	zh-CN
sidachangsheng	四大长生	zh-CN
wuge	五合	zh-CN
liuchong	六冲	zh-CN
zixing	自刑	zh-CN
sanxing	三刑	zh-CN
sange	三合	zh-CN
sanhui	三会	zh-CN
bange	半合	zh-CN
gongge	拱合	zh-CN
chenchenzixing	辰辰自刑	zh-CN
wuwuzixing	午午自刑	zh-CN
youyouzixing	酉酉自刑	zh-CN
haihaizixing	亥亥自刑	zh-CN
haiweigongmao	亥未拱卯	zh-CN
yinquxugongwu	寅戌拱午	zh-CN
shenchengongzi	申辰拱子	zh-CN
sichougongyou	巳丑拱酉	zh-CN
sanhuimuju	三会木局	zh-CN
sanhuihuoju	三会火局	zh-CN
sanhuijinju	三会金句	zh-CN
sanhuishuiju	三会水局	zh-CN
sanhuiguanshaju	三会官杀局	zh-CN
sanhuishishangju	三会食伤局	zh-CN
sanhuibijieju	三会比劫局	zh-CN
sanhuicaiju	三会财局	zh-CN
sanhuiyinju	三会印局	zh-CN
sangemuju	三合木局	zh-CN
sangehuoju	三合火局	zh-CN
sangejinju	三合金局	zh-CN
sangeshuiju	三合水局	zh-CN
sangeguanju	三合官局	zh-CN
sangeshaju	三合杀局	zh-CN
sangeguanshaju	三合官杀局	zh-CN
sangeshishenju	三合食神局	zh-CN
sangeshangguanju	三合伤官局	zh-CN
sangeyinju	三合印局	zh-CN
sangecaiju	三合财局	zh-CN
sangebijieju	三合比劫局	zh-CN
sangeyangrenju	三合阳刃局	zh-CN
yinsishensanxing	寅巳申三刑	zh-CN
chouweiquxusanxing	丑未戌三刑	zh-CN
haimaobange	亥卯半合	zh-CN
haimaoge	亥卯合	zh-CN
maoweibange	卯未半合	zh-CN
maoweige	卯未合	zh-CN
yinwubange	寅午半合	zh-CN
yinwuge	寅午合	zh-CN
wuquxubange	午戌半合	zh-CN
wuquxuge	午戌合	zh-CN
shenzibange	申子半合	zh-CN
shenzige	申子合	zh-CN
zichenbange	子辰半合	zh-CN
zichenge	子辰合	zh-CN
siyoubange	巳酉半合	zh-CN
siyouge	巳酉合	zh-CN
youchoubange	酉丑半合	zh-CN
youchouge	酉丑合	zh-CN
zisiange	子巳暗合	zh-CN
yinchouange	寅丑暗合	zh-CN
maoshenange	卯申暗合	zh-CN
wuhaiange	午亥暗合	zh-CN
yinyouange	寅酉暗合	zh-CN
zimaoxing	子卯刑	zh-CN
yinsixing	寅巳刑	zh-CN
chouquxuxing	丑戌刑	zh-CN
quxuweixing	戌未刑	zh-CN
ziweichuan	子未穿	zh-CN
chouwuchuan	丑午穿	zh-CN
yinsichuan	寅巳穿	zh-CN
maochenchuan	卯辰穿	zh-CN
shenhaichuan	申亥穿	zh-CN
youquxuchuan	酉戌穿	zh-CN
zimaopo	子卯破	zh-CN
maowupo	卯午破	zh-CN
wuyoupo	午酉破	zh-CN
ziyoupo	子酉破	zh-CN
haiweigong	亥未拱	zh-CN
yinquxugong	寅戌拱	zh-CN
shenchengong	申辰拱	zh-CN
sichougong	巳丑拱	zh-CN
yinyangfuyin	阴阳伏吟	zh-CN
rizhugeguan	日主合官	zh-CN
rizhugecai	日主合财	zh-CN
huashashengyin	化杀生印	zh-CN
huaguanshengyin	化官生印	zh-CN
shishangshengcai	食伤生财	zh-CN
shishenzhisha	食神制杀	zh-CN
shishenraoguan	食神扰官	zh-CN
shishengeguan	食神合官	zh-CN
shangguangesha	伤官合杀	zh-CN
shangguanjianguan	伤官见官	zh-CN
shangguanjiasha	伤官驾杀	zh-CN
bijiezhicai	比劫制财	zh-CN
bijiegecai	比劫合财	zh-CN
caigeyin	财合印	zh-CN
caihuaiyin	财坏印	zh-CN
yingeshishen	印合食神	zh-CN
xiaoshenduoshi	枭神夺食	zh-CN
yinzhishangguan	印制伤官	zh-CN
yangrenjiasha	羊刃驾杀	zh-CN
yangrengesha	羊刃合杀	zh-CN
guanzhibijie	官制比劫	zh-CN
shazhibijie	杀制比劫	zh-CN
bijiegesha	比劫合杀	zh-CN
shadaocaiqi	杀盗财气	zh-CN
bijiefenyin	比劫分印	zh-CN
chengge	成格	zh-CN
poge	破格	zh-CN
gejudaiji	格局带忌	zh-CN
sanzhusanxian	三主三限	zh-CN
yuexian	月限	zh-CN
rixian	日限	zh-CN
shixian	时限	zh-CN
minggong	命宫	zh-CN
taiyuan	胎元	zh-CN
taixi	胎息	zh-CN
xiongdigong	兄弟宫	zh-CN
fuqigong	夫妻宫	zh-CN
zinügong	子女宫	zh-CN
caibogong	财帛宫	zh-CN
jiegong	疾厄宫	zh-CN
qianyigong	迁移宫	zh-CN
jiaoyougong	交友宫	zh-CN
guanlugong	官禄宫	zh-CN
tianzhaigong	田宅宫	zh-CN
fudegong	福德宫	zh-CN
fumugong	父母宫	zh-CN
ziwei	紫微	zh-CN
tianji	天机	zh-CN
taiyang	太阳	zh-CN
wuqu	武曲	zh-CN
tiantong	天同	zh-CN
lianzhen	廉贞	zh-CN
tianfu	天府	zh-CN
tanlang	贪狼	zh-CN
jumen	巨门	zh-CN
tianxiang	天相	zh-CN
tianliang	天梁	zh-CN
pojun	破军	zh-CN
qingyang	擎羊	zh-CN
tuoluo	陀罗	zh-CN
huoxing	火星	zh-CN
lingxing	铃星	zh-CN
dijie	地劫	zh-CN
dikong	地空	zh-CN
huaji	化忌	zh-CN
huake	化科	zh-CN
huaquan	化权	zh-CN
hualu	化禄	zh-CN
fumudong	父母动	zh-CN
zisundong	子孙动	zh-CN
qicaidong	妻财动	zh-CN
xiongdidong	兄弟动	zh-CN
guanguidong	官鬼动	zh-CN
tianshi	天时	zh-CN
dili	地利	zh-CN
renhe	人和	zh-CN
yueguanshicai	月官时财	zh-CN
yueguanshiyin	月官时印	zh-CN
shenwang	身旺	zh-CN
shenruo	身弱	zh-CN
detianshi	得天时	zh-CN
dedili	得地利	zh-CN
derenhe	得人和	zh-CN
guanduobugui	官多不贵	zh-CN
zhengpiancaihunza	正偏财混杂	zh-CN
lingxiaodeyong	灵枭得用	zh-CN
touguan	透官	zh-CN
tousha	透杀	zh-CN
toucai	透财	zh-CN
toupiancai	透偏财	zh-CN
touyin	透印	zh-CN
toupianyin	透偏印	zh-CN
touxiao	透枭	zh-CN
toushi	透食	zh-CN
toushang	透伤	zh-CN
toubi	透比	zh-CN
toujiecai	透劫财	zh-CN
touyangren	透阳刃	zh-CN
zhengfu	正夫	zh-CN
pianfu	偏夫	zh-CN
fuxing	夫星	zh-CN
zixing	子星	zh-CN
yongshen	用神	zh-CN
xiangshen	相神	zh-CN
jishen	忌神	zh-CN
andong	暗动	zh-CN
baidi	败地	zh-CN
bangfu	帮扶	zh-CN
bangshen	帮身	zh-CN
beifangshui	北方水	zh-CN
nanfanghuo	南方火	zh-CN
dongfangmu	东方木	zh-CN
xifangjin	西方金	zh-CN
zhongyangtu	中央土	zh-CN
benqi	本气	zh-CN
zhongqi	中气	zh-CN
yuqi	余气	zh-CN
muku	墓库	zh-CN
shuimu	水墓	zh-CN
shuiku	水库	zh-CN
huomu	火墓	zh-CN
huoku	火库	zh-CN
mumu	木墓	zh-CN
muku	木库	zh-CN
jinmu	金墓	zh-CN
jinku	金库	zh-CN
guanshaku	官杀库	zh-CN
bijieku	比劫库	zh-CN
shishangku	食伤库	zh-CN
yinku	印库	zh-CN
caiku	财库	zh-CN
bengua	本卦	zh-CN
biangua	变卦	zh-CN
bingdi	病地	zh-CN
sijuedi	四绝地	zh-CN
rumu	入墓	zh-CN
kaiku	开库	zh-CN
biku	闭库	zh-CN
xutou	虚透	zh-CN
getou	盖头	zh-CN
jiejue	截脚	zh-CN
manluyixiang	满路异香	zh-CN
huhuanlu	互换禄	zh-CN
huhuangui	互换贵	zh-CN
yuepo	月破	zh-CN
yuege	月合	zh-CN
yuebi	月比	zh-CN
tianshi	填实	zh-CN
choushen	仇神	zh-CN
chuchuan	初传	zh-CN
zhongchuan	中传	zh-CN
mochuan	末传	zh-CN
daming	大命	zh-CN
nianzhu	年柱	zh-CN
niangan	年干	zh-CN
nianzhi	年支	zh-CN
yuezhu	月柱	zh-CN
yuegan	月干	zh-CN
yueling	月令	zh-CN
yuezhi	月支	zh-CN
rizhu	日柱	zh-CN
rigan	日干	zh-CN
rizhu	日主	zh-CN
rizhi	日支	zh-CN
shizhu	时柱	zh-CN
shigan	时干	zh-CN
shizhi	时支	zh-CN
daizhan	代占	zh-CN
tianpan	天盘	zh-CN
dipan	地盘	zh-CN
renpan	人盘	zh-CN
tiandao	天道	zh-CN
didao	地道	zh-CN
rendao	人道	zh-CN
nayin	纳音	zh-CN
shensha	神煞	zh-CN
dingqi	丁奇	zh-CN
yiqi	乙奇	zh-CN
bingqi	丙奇	zh-CN
kanyigong	坎一宫	zh-CN
kunergong	坤二宫	zh-CN
zhensangong	震三宫	zh-CN
xunsigong	巽四宫	zh-CN
zhongwugong	中五宫	zh-CN
qianliugong	乾六宫	zh-CN
duiqigong	兑七宫	zh-CN
genbagong	艮八宫	zh-CN
lijiugong	离九宫	zh-CN
tianpangan	天盘干	zh-CN
dipangan	地盘干	zh-CN
yingan	引干	zh-CN
tianbashen	天八神	zh-CN
dibashen	地八神	zh-CN
fayong	发用	zh-CN
fukefei	伏克飞	zh-CN
fushengfei	伏生飞	zh-CN
feishengfu	飞生伏	zh-CN
feikefu	飞克伏	zh-CN
feishen	飞神	zh-CN
fushen	伏神	zh-CN
geju	格局	zh-CN
quxiang	取象	zh-CN
guanyun	官运	zh-CN
shayun	杀运	zh-CN
yinyun	印运	zh-CN
bijieyun	比劫运	zh-CN
yangrenyun	阳刃运	zh-CN
jiecaiyun	劫财运	zh-CN
shishenyun	食神运	zh-CN
shangguanyun	伤官运	zh-CN
shishangyun	食伤运	zh-CN
caiyun	财运	zh-CN
geban	合绊	zh-CN
gehua	合化	zh-CN
geqi	合起	zh-CN
gedong	合动	zh-CN
gelai	合来	zh-CN
gequ	合去	zh-CN
cuogua	错卦	zh-CN
hugua	互卦	zh-CN
zonggua	综卦	zh-CN
huahuitouke	化回头克	zh-CN
huahuitousheng	化回头生	zh-CN
kunzao	坤造	zh-CN
qianzao	乾造	zh-CN
laoyang	老阳	zh-CN
shaoyang	少阳	zh-CN
laoyin	老阴	zh-CN
shaoyin	少阴	zh-CN
liuyue	流月	zh-CN
liuri	流日	zh-CN
lushen	禄神	zh-CN
ziyue	子月	zh-CN
zishi	子时	zh-CN
chouyue	丑月	zh-CN
choushi	丑时	zh-CN
yinyue	寅月	zh-CN
yinshi	寅时	zh-CN
maoyue	卯月	zh-CN
maoshi	卯时	zh-CN
chenyue	辰月	zh-CN
chenshi	辰时	zh-CN
siyue	巳月	zh-CN
sishi	巳时	zh-CN
wuyue	午月	zh-CN
wushi	午时	zh-CN
weiyue	未月	zh-CN
weishi	未时	zh-CN
shenyue	申月	zh-CN
shenshi	申时	zh-CN
youyue	酉月	zh-CN
youshi	酉时	zh-CN
quxuyue	戌月	zh-CN
quxushi	戌时	zh-CN
haiyue	亥月	zh-CN
haishi	亥时	zh-CN
chunyue	春月	zh-CN
xiayue	夏月	zh-CN
qiuyue	秋月	zh-CN
dongyue	冬月	zh-CN
muju	木局	zh-CN
huoju	火局	zh-CN
jinju	金局	zh-CN
shuiju	水局	zh-CN
changsheng	长生	zh-CN
muyu	沐浴	zh-CN
guandai	冠带	zh-CN
linguan	临官	zh-CN
diwang	帝旺	zh-CN
shuai	衰	zh-CN
bing	病	zh-CN
si	死	zh-CN
mu	墓	zh-CN
jue	绝	zh-CN
tai	胎	zh-CN
yang	养	zh-CN
muyutaohua	沐浴桃花	zh-CN
langguntaohua	浪滚桃花	zh-CN
qiangwaitaohua	墙外桃花	zh-CN
qiangnataohua	墙内桃花	zh-CN
taohuaren	桃花刃	zh-CN
taohuajie	桃花劫	zh-CN
bianyetaohua	遍野桃花	zh-CN
guirentaohua	贵人桃花	zh-CN
rizuotaohua	日坐桃花	zh-CN
caixingtaohua	财星桃花	zh-CN
nagua	内卦	zh-CN
waigua	外卦	zh-CN
richong	日冲	zh-CN
rige	日合	zh-CN
ripo	日破	zh-CN
risheng	日生	zh-CN
richen	日辰	zh-CN
zhichen	支辰	zh-CN
riyuan	日元	zh-CN
zuomu	坐墓	zh-CN
zuoku	坐库	zh-CN
shengfu	生扶	zh-CN
shengnian	生年	zh-CN
shengyue	生月	zh-CN
shengri	生日	zh-CN
shengshi	生时	zh-CN
shiling	失令	zh-CN
deling	得令	zh-CN
shiying	世应	zh-CN
xiangchong	相冲	zh-CN
xiangge	相合	zh-CN
xiangke	相克	zh-CN
shumu	属木	zh-CN
shuhuo	属火	zh-CN
shutu	属土	zh-CN
shujin	属金	zh-CN
shushui	属水	zh-CN
mushenghuo	木生火	zh-CN
muketu	木克土	zh-CN
huoshengtu	火生土	zh-CN
huokejin	火克金	zh-CN
tushengjin	土生金	zh-CN
tukeshui	土克水	zh-CN
jinshengshui	金生水	zh-CN
jinkemu	金克木	zh-CN
shuishengmu	水生木	zh-CN
shuikehuo	水克火	zh-CN
wuxing	五行	zh-CN
liushen	六神	zh-CN
shishen	十神	zh-CN
luming	禄命	zh-CN
suiyunbinglin	岁运并临	zh-CN
tianbidichong	天比地冲	zh-CN
gangezhichong	干合支冲	zh-CN
gangezhixing	干合支刑	zh-CN
tiandeguiren	天德贵人	zh-CN
yuedeguiren	月德贵人	zh-CN
tiankedichong	天克地冲	zh-CN
waiying	外应	zh-CN
xiangchuan	相穿	zh-CN
xianghai	相害	zh-CN
xiangxing	相刑	zh-CN
xiaoyun	小运	zh-CN
xiaoxian	小限	zh-CN
xingke	刑克	zh-CN
yangnan	阳男	zh-CN
yangnü	阳女	zh-CN
yinnan	阴男	zh-CN
yinnü	阴女	zh-CN
yaowei	爻位	zh-CN
yongjiu	用九	zh-CN
yongliu	用六	zh-CN
yongshenkeshi	用神克世	zh-CN
yongshenshengshi	用神生世	zh-CN
yongshenchishi	用神持世	zh-CN
guanguichishi	官鬼持世	zh-CN
fumuchishi	父母持世	zh-CN
zisunchishi	子孙持世	zh-CN
qicaichishi	妻财持世	zh-CN
xiongdichishi	兄弟持世	zh-CN
yongshenxiuqiu	用神休囚	zh-CN
yongshenwangxiang	用神旺相	zh-CN
guanguixiuqiu	官鬼休囚	zh-CN
guanguiwangxiang	官鬼旺相	zh-CN
fumuxiuqiu	父母休囚	zh-CN
fumuwangxiang	父母旺相	zh-CN
xiongdixiuqiu	兄弟休囚	zh-CN
xiongdiwangxiang	兄弟旺相	zh-CN
zisunxiuqiu	子孙休囚	zh-CN
zisunwangxiang	子孙旺相	zh-CN
qicaixiuqiu	妻财休囚	zh-CN
qicaiwangxiang	妻财旺相	zh-CN
yuejian	月建	zh-CN
yuesheng	月生	zh-CN
zaqiguange	杂气官格	zh-CN
zaqishage	杂气杀格	zh-CN
zaqiyinge	杂气印格	zh-CN
zaqicaige	杂气财格	zh-CN
baziwuguan	八字无官	zh-CN
baziwucai	八字无财	zh-CN
bijieduocai	比劫夺财	zh-CN
chouyaosilu	丑遥巳禄	zh-CN
congcaige	从财格	zh-CN
congerge	从儿格	zh-CN
congshage	从杀格	zh-CN
guguanwufu	孤官无辅	zh-CN
guanxingdairen	官星带刃	zh-CN
qushaliuguan	去杀留官	zh-CN
quguanliusha	去官留杀	zh-CN
huaqige	化气格	zh-CN
muhuotongming	木火通明	zh-CN
jinmujiange	金木间隔	zh-CN
liangganbuza	两干不杂	zh-CN
liangshenchengxiang	两神成象	zh-CN
nianshangbijie	年上比劫	zh-CN
nianshangpiancai	年上偏财	zh-CN
nianshangpianyin	年上偏印	zh-CN
nianshangshangguan	年上伤官	zh-CN
nianshangshishen	年上食神	zh-CN
nianshangzhengcai	年上正财	zh-CN
nianshangzhengguan	年上正官	zh-CN
nianshangzhengyin	年上正印	zh-CN
rifansuijun	日犯岁君	zh-CN
riluguishi	日禄归时	zh-CN
shishangxiexiu	食伤泄秀	zh-CN
shenshaerting	身杀二停	zh-CN
shishangtuxiu	食伤吐秀	zh-CN
taohuasha	桃花煞	zh-CN
tianganshunshi	天干顺食	zh-CN
tianyuanzuolu	天元坐禄	zh-CN
zhenshangguan	真伤官	zh-CN
zhichenyizi	支辰一字	zh-CN
ziwushuangbao	子午双包	zh-CN
xunkong	旬空	zh-CN
yaogua	摇卦	zh-CN
zihuaji	自化忌	zh-CN
zihuake	自化科	zh-CN
zihualu	自化禄	zh-CN
zihuaquan	自化权	zh-CN
zizhan	自占	zh-CN
yunxian	运限	zh-CN
yuanshen	原神	zh-CN
tianxianshige	天显时格	zh-CN
qinglongrudi	青龙入地	zh-CN
qinglongruyun	青龙入云	zh-CN
qinglonghuishou	青龙回首	zh-CN
qinglongyaoming	青龙耀明	zh-CN
qinglongxiangge	青龙相合	zh-CN
qinglongshishi	青龙失势	zh-CN
qinglongzhezu	青龙折足	zh-CN
qinglongruyu	青龙入狱	zh-CN
qinglonghuage	青龙华盖	zh-CN
yutudongsheng	玉兔东升	zh-CN
yutuchengfeng	玉兔乘风	zh-CN
yutudangyang	玉兔当阳	zh-CN
yutushouzhi	玉兔受制	zh-CN
yuturulin	玉兔入林	zh-CN
yutuyinquan	玉兔饮泉	zh-CN
yunüshengtang	玉女升堂	zh-CN
rishangqingyun	日上青云	zh-CN
qirutianmen	奇入天门	zh-CN
qizhongfuqi	奇中伏奇	zh-CN
qiyixiangzuo	奇仪相佐	zh-CN
riqiruwu	日奇入雾	zh-CN
taibaiqige	太白奇合	zh-CN
qishenruyu	奇神入狱	zh-CN
qifengluowang	奇逢罗网	zh-CN
feiniaodiexue	飞鸟跌穴	zh-CN
riyuebingxing	日月并行	zh-CN
xingyueshenghui	星月生辉	zh-CN
qirumingtang	奇入明堂	zh-CN
yingrutaibai	荧入太白	zh-CN
qishenshengge	奇神生合	zh-CN
qishenyouhai	奇神游海	zh-CN
qifenghuage	奇逢华盖	zh-CN
zhuquetoujiang	朱雀投江	zh-CN
yunüdengtang	玉女登堂	zh-CN
huofanjinxiang	火犯金乡	zh-CN
huozhaotianmen	火照天门	zh-CN
yunüchengfeng	玉女乘风	zh-CN
yunüqilong	玉女骑龙	zh-CN
yunüqisheng	玉女奇生	zh-CN
yunüshien	玉女施恩	zh-CN
yunüxingsha	玉女刑杀	zh-CN
yunüfuhu	玉女伏虎	zh-CN
mingtangtansheng	明堂贪生	zh-CN
dihufenggui	地户逢鬼	zh-CN
mingtangfusha	明堂伏杀	zh-CN
hunshenrumu	魂神入墓	zh-CN
xingwanggaozhang	刑网高张	zh-CN
dixingxuanwu	地刑玄武	zh-CN
taibairuying	太白入荧	zh-CN
taibaishouzhi	太白受制	zh-CN
longhuzhengdou	龙虎争斗	zh-CN
baihuchangkuang	白虎猖狂	zh-CN
baihushoushang	白虎受伤	zh-CN
sheruyuxing	蛇入狱刑	zh-CN
qinglongpoyu	青龙破狱	zh-CN
zhengguanweiyong	正官为用	zh-CN
qishaweiyong	七杀为用	zh-CN
pianguanweiyong	偏官为用	zh-CN
zhengyinweiyong	正印为用	zh-CN
pianyinweiyong	偏印为用	zh-CN
yinshouweiyong	印绶为用	zh-CN
zhengcaiweiyong	正财为用	zh-CN
piancaiweiyong	偏财为用	zh-CN
shishenweiyong	食神为用	zh-CN
shangguanweiyong	伤官为用	zh-CN
chuxian	初限	zh-CN
zhongxian	中限	zh-CN
moxian	末限	zh-CN
wanxian	晚限	zh-CN
shangguanshangjin	伤官伤尽	zh-CN
nianganguanxing	年干官星	zh-CN
yueganguanxing	月干官星	zh-CN
shiganguanxing	时干官星	zh-CN
zuoxiazhengguan	坐下正官	zh-CN
zuoxiaqisha	坐下七杀	zh-CN
zuoxiaguanxing	坐下官星	zh-CN
zuoxiazhengyin	坐下正印	zh-CN
zuoxiapianyin	坐下偏印	zh-CN
zuoxiaxiaoyin	坐下枭印	zh-CN
zuoxiaxiaoshen	坐下枭神	zh-CN
zuoxiashishen	坐下食神	zh-CN
zuoxiashangguan	坐下伤官	zh-CN
zuoxiabijie	坐下比劫	zh-CN
zuoxiayangren	坐下阳刃	zh-CN
zuoxiazhengcai	坐下正财	zh-CN
zuoxiapiancai	坐下偏财	zh-CN
shishangzhengguan	时上正官	zh-CN
shishangqisha	时上七杀	zh-CN
shishangpianguan	时上偏官	zh-CN
shishangpianyin	时上偏印	zh-CN
shishangzhengyin	时上正印	zh-CN
shishangshangguan	时上伤官	zh-CN
shishangshishen	时上食神	zh-CN
shishangbijie	时上比劫	zh-CN
shishangyangren	时上阳刃	zh-CN
shishangjiecai	时上劫财	zh-CN
shishangbijian	时上比肩	zh-CN
shishangzhengcai	时上正财	zh-CN
shishangpiancai	时上偏财	zh-CN
yueshangzhengguan	月上正官	zh-CN
yueshangqisha	月上七杀	zh-CN
yueshangguanxing	月上官星	zh-CN
yueshangzhengyin	月上正印	zh-CN
yueshangpianyin	月上偏印	zh-CN
yueshangbijian	月上比肩	zh-CN
yueshangjiecai	月上劫财	zh-CN
yueshangbijie	月上比劫	zh-CN
yueshangshishen	月上食神	zh-CN
yueshangshangguan	月上伤官	zh-CN
yueshangzhengcai	月上正财	zh-CN
yueshangpiancai	月上偏财	zh-CN
yuelingzhengguan	月令正官	zh-CN
yuelingqisha	月令七杀	zh-CN
yuelingzhengyin	月令正印	zh-CN
yuelingpianyin	月令偏印	zh-CN
yuelingjiecai	月令劫财	zh-CN
yuelinglushen	月令禄神	zh-CN
yuelingyangren	月令阳刃	zh-CN
yuelingshishen	月令食神	zh-CN
yuelingshangguan	月令伤官	zh-CN
yuelingzhengcai	月令正财	zh-CN
yuelingpiancai	月令偏财	zh-CN
yuelingzaqi	月令杂气	zh-CN
yuelingguanshaku	月令官杀库	zh-CN
yuelingbijieku	月令比劫库	zh-CN
yuelingyinku	月令印库	zh-CN
yuelingshishangku	月令食伤库	zh-CN
yuelingcaiku	月令财库	zh-CN
yuelingmuku	月令墓库	zh-CN
butou	不透	zh-CN
gaotou	高透	zh-CN
touchu	透出	zh-CN
xuyao	虚邀	zh-CN
angong	暗拱	zh-CN
xuyaoangong	虚邀暗拱	zh-CN
anyao	暗邀	zh-CN
anchong	暗冲	zh-CN
